's Gravenbrakel	's  Gravenbrakel
's Gravenvoeren	's  gravenvoeren
's Gravenwezel	's  Gravenwezel
's Herenelderen	's  Herenelderen
Aa en Hunze	Aa e Hunze	A-a en Hunze
Abel Tasman	
Aboe Simbel	
Abraham Kuyper	Abraham Kuijper
Abraham Lincoln	
Abu Dhabi	Aboe Dhabi
Addis Abeba	Ad dis Abeba
Addis Abebaër	Ad dis Abebaër
Addis Abebiet	Ad dis Abebiet
Addis Abebitisch	Ad dis Abebitisch
Adolf Hitler	
Adriatische Zee	Adriatische Zeen
Afrikaans Schild	Afrikaans Schilt
Agatha Christie	Agatha Christien	Agatha Christy	Agatha Christi
Agnus Dei	Agnus Die	Agnus Dij
Albanese Alpen	
Albert Einstein	
Albert Schweitzer	
Aletta Jacobs	Aletta Jakobs
Alexander de Grote	Alenxander de Grote	Alexandenr de Grote	Alexander den Grote	Alexandërs de Grote	Allexander de Grote	Alexandder de Grote	Aleksander de Grote	Alijxander de Grote	Alexandijr de Grote	Alexander dij Grote	Aleczander de Grote	Alaixander de Grote	Alexandair de Grote	Alexandeder de Grote
Alfred Nobel	
Alphen aan den Rijn	Alphe aan den Rijn	Alphen aan de Rijn	Alphen a-an den Rijn	Alphenn aan den Rijn	Allphen aan den Rijn	Alphen aan den Rijn	Alphijn aan den Rijn	Alphen aan dijn Rijn	Alphen aan den Rein	Alfen aan den Rijn	Alphain aan den Rijn	Alphen aan deden Rijn
Ambt Montfort	Ambt Mondfort
Amerikaanse Maagdeneilanden	
Amu Darja	
Anatolisch Hoogland	
Andamanse Zee	Andamanse Zeen
Andorra la Vella	Anddorra la Vella	Andeaurra la Vella
Anna Paulowna	
Anne Frank	Anne Franc	Annen Frank
Annie M.G. Schmidt	Anni-e M.G. Schmidt	Annien M.G. Schmidt	Anniet M.G. Schmidt	Anniij M.G. Schmidt	Anny M.G. Schmidt	Anny' M.G. Schmidt	Anniai M.G. Schmidt	Anni M.G. Schmidt
Antarctisch Schiereiland	
Antigua en Barbuda	Antigua e Barbuda	Anthigua en Barbuda	Antigoea en Barbuda	Antichua en Barbuda	Andigua en Barbuda	Antigija en Barbuda	Antiggeua en Barbuda
Anton Pieck	Anthon Pieck
Apennijns Schiereiland	Apennijns Schiereiland
Aquitaanse Poort	
Arabisch Bekken	Arabisch Bekke
Arabische Woestijn	Arabische Woestijn
Arabische Zee	Arabische Zeen
Arcen en Velden	Arssen En velden	Arken En velden	Arcenn En velden	Arcen En velde	Arcen E velden	Arce En velden	Arcain En velden	Arcen En vijlden	Arcijn En velden
Argentijns Bekken	Argentijns Bekken	Argentijns Bekke
Armoricaans Massief	
Arthur Conan Doyle	Arthhur Conan Doyle	Arthoer Conan Doyle	Ardhur Conan Doyle	Arthijr Conan Doyle
Asturisch-Cantabrisch Gebergte	Asturisch-Cantabrisch Gebergten
Atlantisch-Indisch-Antarctisch Bekken	Atlantisch-Indisch-Antarctisch Bekke	Atlantisch-Indisch-Antarctisch
Atlantisch-Indische Rug	Atlantisch-Indische
Atlantische Kustvlakte	Atlantische Kustvlakten
Atlantische Oceaan	
Auguste Rodin	
Australische Alpen	
Ayaan Hirsi Ali	Aya-an Hirsi Ali	Aijaan Hirsi Ali
Ayatollah Khomeini	
Ayers Rock	
Baai van Kotor	Bae van Kotor	Ba-ai van Kotor	Baa-i van Kotor
Baai van Mont-Saint-Michel	Bae van Mont-Saint-Michel	Ba-ai van Mont-Saint-Michel	Baa-i van Mont-Saint-Michel
Baai van Peter de Grote	Baai van Pether de Grote	Bae van Peter de Grote	Ba-ai van Peter de Grote	Baa-i van Peter de Grote	Baai van Petter de Grote	Baai van Penter de Grote	Baai van Petenr de Grote	Baai van Peter den Grote	Baai van Petërs de Grote	Baai van Pijter de Grote	Baai van Petijr de Grote	Baai van Peter dij Grote	Baai van Peder de Grote	Baai van Paiter de Grote
Baai van Sint-Michiel	Bae van Sint-Michiel	Ba-ai van Sint-Michiel	Baa-i van Sint-Michiel
Bab el Mandeb	Bab ijl Mandeb
Balthasar Gerards	
Banater Gebergte	Banater Gebergten
Banda Aceh	
Bandar Abbas	Bandar Abba's
Bandar Seri Begawan	Banddar Seri Begawan
Barbarijse Hoogvlakte	Barbarijse Hoogvlakte	Barbarijse Hoogvlakten
Baruch de Spinoza	Baruch den Spinoza	Baroech de Spinoza	Barukh de Spinoza	Barussh de Spinoza	Baruch dij Spinoza	Barijch de Spinoza	Barug de Spinoza
Baskische Provincies	
Bataafse Republiek	
Beierse Alpen	
Beierse Hoogvlakte	Beierse Hoogvlakten
Beierse Woud	Beierse Wout
Bekken van Parijs	Bekke van Parijs	Benkken van Parijs	Bekkenn van Parijs	Bektjen van Parijs	Bekken van Parijs	Bijkken van Parijs	Bekkijn van Parijs	Bequken van Parijs	Bekquen van Parijs	Beccen van Parijs	Beccken van Parijs	Bekccen van Parijs	Baikken van Parijs	Bekkain van Parijs	Becken van Parijs
Benedenwindse Eilanden	
Benedictus de Spinoza	Beedictus de Spinoza	Benedicthus de Spinoza	Benedictuss de Spinoza	Bennedictus de Spinoza	Benendictus de Spinoza	Benedictus den Spinoza	Benedictoes de Spinoza	Beneddictus de Spinoza	Benediktus de Spinoza	Benedisstus de Spinoza	Bijnedictus de Spinoza	Benijdictus de Spinoza	Benedictus dij Spinoza	Benedicdus de Spinoza	Benedictijs de Spinoza
Benito Mussolini	
Bergen op Zoom	Bijrgen Op zoom	Bërsgen Op zoom	Bergenn Op zoom	Benrgen Op zoom	Berge Op zoom	Berggeen Op zoom	Bergain Op zoom	Bairgen Op zoom	Berchen Op zoom	Bergijn Op zoom
Berkel en Rodenrijs	Berkel e Rodenrijs	Benrkel en Rodenrijs	Berkenl en Rodenrijs	Bërskel en Rodenrijs	Berkell en Rodenrijs	Bertjel en Rodenrijs	Berkel en Rodenrijs	Bijrkel en Rodenrijs	Berkijl en Rodenrijs	Berquel en Rodenrijs	Berccel en Rodenrijs	Bairkel en Rodenrijs	Berkail en Rodenrijs	Bercel en Rodenrijs
Bernadette Soubirous	
Bill Clinton	
Bill Gates	
Blauwe Nijl	Blauwen Nijl	Blauwe Nijl	Blauwe Neil
Blauwe Rivier	Blauwen Rivier
Bocht van Gdansk	Bochth van Gdansk	Bokht van Gdansk	Bossht van Gdansk	Bochd van Gdansk	Bogt van Gdansk	Bogd van Gdansk	Beaucht van Gdansk
Bocht van Helgoland	Bochth van Helgoland	Bokht van Helgoland	Bossht van Helgoland	Bochd van Helgoland	Bogt van Helgoland	Bogd van Helgoland	Beaucht van Helgoland
Boergondisch Kanaal	
Boergondische Poort	
Boheems-Moravische Hoogten	Boheems-Moravische Hoogden	Boheems-Moravische Hoogte
Bohemer Woud	Bohemer Wout
Bos en Lommer	Beaus En lommer	Bosch En lommer	Boss En lommer	Bos E lommer
Bourgondisch Kanaal	
Bourgondische Poort	
Boven-Rijnse Laagvlakte	Boven-Rijnse Laagvlakte
Braziliaans Bekken	Braziliaans Bekke
Britse Maagdeneilanden	Britsen Maagdeneilanden
Buenos Airees	
Buenos Aires	
Burkina Faso	
Campanische Archipel	
Canadees Bekken	Canadees Bekke	Canadeesbekken
Canadees Schild	Canadeesschild
Cantabrisch Gebergte	Cantabrisch Gebergten
Capelle aan den IJssel	Capelle aan de IJssel	Capelle a-an den IJssel	Capenlle aan den IJssel	Capellen aan den IJssel	Capellle aan den IJssel	Capijlle aan den IJssel	Capellij aan den IJssel	Capelle aan dijn IJssel	Capaille aan den IJssel	Capellai aan den IJssel	Capelle aan deden IJssel
Caraïbische Zee	Caraïbische Zeen
Caribische Zee	Caribische Zeen
Carolus Borromeus	
Cees Buddingh'	Kees Buddingh'
Centraal Massief	
Centraal-Afrikaanse Meren	Centraal-Afrikaanse Mere	Centraal-Afrikaanse Merijn
Centraal-Afrikaanse Republiek	
Centraal-Indische Rug	Centraal-Indische
Centraal-Pacifisch Bekken	Centraal-Pacifisch Bekke
Centraal-Pacifische Rug	Centraal-Pacifische
Centrale Cordillera	
Centrumraad Rotterdam	
Charles Darwin	
Charles Dickens	Charles Dickes	Charles Dikkens
Charles Lindbergh	
Charles de Gaulle	Charless de Gaulle	Charlens de Gaulle	Charles den Gaulle	Charlles de Gaulle	Charlijs de Gaulle	Charles dij Gaulle	Charlesch de Gaulle	Charlais de Gaulle	Kharles de Gaulle	Ssharles de Gaulle
Charlie Chaplin	Charly Chaplin
Charlotte Amalie	
Che Guevara	Chen Guevara	Ge Guevara	Chai Guevara
Chileens Lengtedal	
Chinees Laagland	Chineesslaagland	Chineesklaagland	Chineesplaagland
Christiaan Huygens	Christiaan Huijgens
Christoffel Columbus	
Christoffel Plantijn	Christoffel Plantijn
Claes Janszoon Visscher	Cla-es Janszoon Visscher	Claess Janszoon Visscher	Claens Janszoon Visscher	Cllaes Janszoon Visscher	Claijs Janszoon Visscher	Claesch Janszoon Visscher	Clës Janszoon Visscher	Claais Janszoon Visscher	Klaes Janszoon Visscher	Sslaes Janszoon Visscher
Cockburn Town	Cockburn Down
Constantijn Huygens	Constantijn Huygens	Constantijn Huijgens
Cordillera de los Andes	Cordillera de loss Andes	Cordillenra de los Andes	Cordillera den los Andes	Cordillërsa de los Andes	Cordilllera de los Andes	Corddillera de los Andes	Cordillera dde los Andes	Cordillijra de los Andes	Cordillera dij los Andes	Cordillaira de los Andes	Cordillera dai los Andes	Cordillera dede los Andes	Ceaurdillera de los Andes
Cottische Alpen	
Dalmatische Eilanden	
Dante Alighieri	
David Livingstone	David Livingstonen
De Baarsjes	Den Baarsjes	Dij Baarsjes
De Backer	De Bakker	Den Backer	Dij Backer
De Bilt	Den Bilt	Dij Bilt
De Bruyn	Den Bruyn	De Bruijn	Dij Bruyn
De Clercq	Den Clercq	Dij Clercq	Declercq
De Cock	Den Cock	Dij Cock	Decock
De Coninck	Den Coninck	Dij Coninck
De Groot	Den Groot	Dij Groot
De Groote	De Grootte	Den Groote	De Grooten	Dij Groote
De Haan	Den Haan	Dij Haan
De Klinge	De Klingen	Den Klinge	Dij Klinge
De Meern	Den Meern	Dij Meern
De Meyer	Den Meyer	De Meijer	Dij Meyer
De Moeren	Den Moeren	Dij Moeren	De Moere
De Morgen	Den Morgen	Dij Morgen
De Panne	De Pannen	Den Panne	Dij Panne
De Pauw	Den Pauw	Dij Pauw
De Pinte	De Pinde	De Pinten	Den Pinte	Dij Pinte
De Ridder	Den Ridder	Dij Ridder
De Ronde Venen	De Rondde venen	De Ronde vennen	De Ronden venen	Den Ronde venen	De Ronde veen	Dede Ronde venen	Dai Ronde venen	De Ronde venijn	Dij Ronde venen	Dde Ronde venen
De Smedt	Den Smedt	Dij Smedt	Desmedt
De Smet	De Smijt	Den Smet	Dij Smet	Desmet
De Standaard	Den Standaard	Dij Standaard
De Stijl	De Steil	De Stijl	Den Stijl	Dij Stijl
De Telegraaf	Den Telegraaf	Dij Telegraaf
De Tijd	De Tijd	Den Tijd	Dij Tijd	Dektijd
De Vos	Den Vos	Dij Vos	De Voss	Devos
De Wilde	De Wilden	Den Wilde	Dij Wilde
De Winter	Den Winter	Dij Winter	De Winder
De Wolden	Den Wolden	Dij Wolden
Den Briel	Den Bril	De Briel	Dijn Briel	Deden Briel
Den Ham	De Ham	Deden Ham	Dijn Ham
Den Helder	De Helder	Deden Helder	Dijn Helder
Den Uyl	De Uyl	Den Uijl	Dijn Uyl	Deden Uyl
Deng Xiaoping	
Deo volente	
Desi Bouterse	
Desiderius Erasmus	
Dick Bruna	
Dinarische Alpen	
Dode Zee	Dodde Zee	Dode Zeen	Doden Zee
Domela Nieuwenhuis	
Dominicaanse Republiek	
Douglas Adams	
Dries van Agt	Dri-es van Agt	Driess van Agt	Driens van Agt	Driijs van Agt	Driesch van Agt	Drys van Agt	Dry's van Agt	Drisch van Agt	Driais van Agt	Dris van Agt	Ddries van Agt
Duitse Bocht	
Dwight Eisenhower	
Dzjoengaarse Poort	
E. coli	E. colli
Eddy Merckx	
Edgar Allan Poe	Eddgar Allan Poe	Edchar Allan Poe	Edggear Allan Poe	Endgar Allan Poe	IJdgar Allan Poe	Tgar Allan Poe	Aidgar Allan Poe
Eduard Douwes Dekker	Eduard Douwes Decker
Eerste Kamer	Eersten Kamer
Egadische Eilanden	
Egeïsche Zee	Egeïsche Zeen
Eilanden beneden de wind	Eilande beneden de wind	Eilanden beeden de wind	Eilanden benede de wind	Eilandenn beneden de wind	Eilanden benneden de wind	Eilanden benenden de wind	Eilanden benedenn de wind	Eilanden beneden den wind	Eillanden beneden de wind	Eilandden beneden de wind	Eilanden benedden de wind	Eilandijn beneden de wind	Eilanden bijneden de wind	Eilanden benijden de wind	Eilanden benedijn de wind
Eilanden boven de wind	Eilande boven de wind	Eilanden bove de wind	Eilandenn boven de wind	Eilanden bovenn de wind	Eilanden boven den wind	Eillanden boven de wind	Eilandden boven de wind	Eilandijn boven de wind	Eilanden bovijn de wind	Eilanden boven dij wind	Eilanden boofn de wind	Eilandain boven de wind	Eilanden bovain de wind	Eilandeden boven de wind	Eilanden beauven de wind
Eise Eisinga	Eisen Eisinga
El Obeid	Ell Obeid	IJl Obeid
Elena Ceausescu	
Emile Zola	
Enzo Ferrari	
Eolische Eilanden	
Erich Honecker	
Ernest Hemingway	
Ethiopisch Hoogland	
Etruskische Apennijnen	Etruskische Apennijnen
Eva Braun	
Fehmarn Belt	Fehmarn Beld
Ferdinand Domela Nieuwenhuis	Fenrdinand Domela Nieuwenhuis	Fërsdinand Domela Nieuwenhuis	Ferddinand Domela Nieuwenhuis	Ferdinandd Domela Nieuwenhuis	Fijrdinand Domela Nieuwenhuis	Fairdinand Domela Nieuwenhuis
Fidel Castro	
Filips II	Filips IJ
Filips de Goede	Filips Dij goede	Fillips De goede	Filips De goeden	Filips Den goede	Filipss De goede	Filipss de Goede	Filips den Goede	Fillips de Goede	Filips dij Goede	Filipsch de Goede
Filips de Schone	Filipsch De schone	Filips Dij schone	Fillips De schone	Filips De schonen	Filips Den schone	Filipss De schone
Finse Golf	
Finse Merenvlakte	Finse Merenvlakten
Floris V	
Flying Fish Cove	Flyings Fish Cove	Fllying Fish Cove	Flyinch Fish Cove	Flijing Fish Cove	Flyingge Fish Cove	Flyiging Fish Cove
Franciscus van Assisi	Francisscus van Assisi	Franciscuss van Assisi	Franciscoes van Assisi	Frankiscus van Assisi	Franciskus van Assisi	Franssiscus van Assisi	Francisssus van Assisi	Franciscijs van Assisi	Francischcus van Assisi	Franciscusch van Assisi	Francicuss van Assisi
Frank Zappa	Franc Zappa
Frans Hals	Frans Halls
Franse Alpen	Fransen Alpen
Franz Joseph Strauss	Franss Joseph Strauss	Franz Josef Strauss
Frederik Hendrik	Frederic Hendrik
Friedrich Nietzsche	
Galileo Galilei	
Gautama Boeddha	
Gazet van Antwerpen	Gazeth van Antwerpen	Gazent van Antwerpen	Gazijt van Antwerpen	Gazed van Antwerpen	Gasset van Antwerpen	Gazait van Antwerpen	Chazet van Antwerpen	Ggeazet van Antwerpen
Gele Rivier	Gijle Rivier	Gelen Rivier
Gele Zee	Gijle Zee	Gele Zeen	Gelen Zee
George Orwell	
George W. Bush	Genorge W. Bush	Georgen W. Bush	Gijorge W. Bush	Georgij W. Bush	Georche W. Bush	Gaiorge W. Bush	Georgai W. Bush	Georggee W. Bush	Geeaurge W. Bush	Cheorge W. Bush
Gerard Reve	Gerard Reven
Gerard van Velzen	Genrard van Velzen	Gërsard van Velzen	Gerardd van Velzen	Gijrard van Velzen	Gairard van Velzen	Cherard van Velzen	Ggeerard van Velzen
Gerrit Jan van Heuven Goedhart	Gerrith Jan van Heuven Goedhart	Genrrit Jan van Heuven Goedhart	Gërsrit Jan van Heuven Goedhart	Gijrrit Jan van Heuven Goedhart	Gerrid Jan van Heuven Goedhart	Gairrit Jan van Heuven Goedhart	Cherrit Jan van Heuven Goedhart	Ggeerrit Jan van Heuven Goedhart
Gerrit Krol	Gerrit Kroll
Gerrit Rietveld	Gerrit Rietvelt
Gerry Adams	
Gijsbrecht van Amstel	Gijsbrechth van Amstel	Gi-jsbrecht van Amstel	Gijssbrecht van Amstel	Gijsbrencht van Amstel	Gijsbrechts van Amstel	Gijsbrekht van Amstel	Gijsbrecht van Amstel	Gijsbressht van Amstel	Gijsbrijcht van Amstel	Gijsbrechd van Amstel	Gijschbrecht van Amstel	Gijsbregt van Amstel	Geisbrecht van Amstel	Gijsbregd van Amstel	Gijsbraicht van Amstel
Gilze en Rijen	Gilzij En rijen	Gilze En rijen	Gillze En rijen	Gilzen En rijen	Gilze E rijen	Ggeilze En rijen	Gilzai En rijen	Gilze En reien	Gilsse En rijen	Chilze En rijen
Godfried Bomans	
Golf van Aden	Golf van Ade	Gollf van Aden	Geaulf van Aden	Cholf van Aden	Ggeolf van Aden
Golf van Ajaccio	Gollf van Ajaccio	Geaulf van Ajaccio	Cholf van Ajaccio	Ggeolf van Ajaccio
Golf van Akaba	Gollf van Akaba	Geaulf van Akaba	Cholf van Akaba	Ggeolf van Akaba
Golf van Anadyr	Gollf van Anadyr	Geaulf van Anadyr	Cholf van Anadyr	Ggeolf van Anadyr
Golf van Argolis	Gollf van Argolis	Geaulf van Argolis	Cholf van Argolis	Ggeolf van Argolis
Golf van Bengalen	Gollf van Bengalen	Geaulf van Bengalen	Cholf van Bengalen	Ggeolf van Bengalen
Golf van Boergas	Gollf van Boergas	Geaulf van Boergas	Cholf van Boergas	Ggeolf van Boergas
Golf van Bone	Golf Van bonen	Golf Van bonte	Golf van Bonte	Gollf van Bone	Geaulf van Bone	Cholf van Bone	Ggeolf van Bone
Golf van Californië	Gollf van Californië	Geaulf van Californië	Cholf van Californië	Ggeolf van Californië
Golf van Egina	Gollf van Egina	Geaulf van Egina	Cholf van Egina	Ggeolf van Egina
Golf van Gabès	Gollf van Gabès	Geaulf van Gabès	Cholf van Gabès	Ggeolf van Gabès
Golf van Genua	Geaulf Van genua	Gollf Van genua	Ggeolf Van genua	Cholf Van genua	Gollf van Genua	Geaulf van Genua	Cholf van Genua	Ggeolf van Genua
Golf van Guinee	Gollf van Guinee	Geaulf van Guinee	Cholf van Guinee	Ggeolf van Guinee
Golf van Kiparissia	Gollf van Kiparissia	Geaulf van Kiparissia	Cholf van Kiparissia	Ggeolf van Kiparissia
Golf van Korinthe	Gollf van Korinthe	Geaulf van Korinthe	Cholf van Korinthe	Ggeolf van Korinthe
Golf van Martaban	Gollf van Martaban	Geaulf van Martaban	Cholf van Martaban	Ggeolf van Martaban
Golf van Messina	Gollf van Messina	Geaulf van Messina	Cholf van Messina	Ggeolf van Messina
Golf van Mexico	Gollf van Mexico	Geaulf van Mexico	Cholf van Mexico	Ggeolf van Mexico
Golf van Napels	Gollf van Napels	Geaulf van Napels	Cholf van Napels	Ggeolf van Napels
Golf van Oman	Gollf van Oman	Geaulf van Oman	Cholf van Oman	Ggeolf van Oman
Golf van Patras	Gollf van Patras	Geaulf van Patras	Cholf van Patras	Ggeolf van Patras
Golf van Petalia	Gollf van Petalia	Geaulf van Petalia	Cholf van Petalia	Ggeolf van Petalia
Golf van Riga	Gollf van Riga	Geaulf van Riga	Cholf van Riga	Ggeolf van Riga
Golf van Rijeka	Gollf van Rijeka	Golf van Rijeka	Geaulf van Rijeka	Cholf van Rijeka	Ggeolf van Rijeka
Golf van Sidra	Gollf van Sidra	Geaulf van Sidra	Cholf van Sidra	Ggeolf van Sidra
Golf van Strimon	Gollf van Strimon	Geaulf van Strimon	Cholf van Strimon	Ggeolf van Strimon
Golf van Suez	Gollf van Suez	Geaulf van Suez	Cholf van Suez	Ggeolf van Suez
Golf van Tarente	Gollf van Tarente	Geaulf van Tarente	Cholf van Tarente	Ggeolf van Tarente
Golf van Thailand	Gollf van Thailand	Geaulf van Thailand	Cholf van Thailand	Ggeolf van Thailand
Golf van Thessaloniki	Gollf van Thessaloniki	Geaulf van Thessaloniki	Cholf van Thessaloniki	Ggeolf van Thessaloniki
Golf van Tolo	Gollf van Tolo	Geaulf van Tolo	Cholf van Tolo	Ggeolf van Tolo
Golf van Tomini	Gollf van Tomini	Geaulf van Tomini	Cholf van Tomini	Ggeolf van Tomini
Golf van Tonkin	Gollf van Tonkin	Geaulf van Tonkin	Cholf van Tonkin	Ggeolf van Tonkin
Golf van Triëst	Gollf van Triëst	Geaulf van Triëst	Cholf van Triëst	Ggeolf van Triëst
Golf van Venetië	Gollf van Venetië	Geaulf van Venetië	Cholf van Venetië	Ggeolf van Venetië
Golf van Volos	Gollf van Volos	Geaulf van Volos	Cholf van Volos	Ggeolf van Volos
Gouden Hoorn	
Graft-De Rijp	Graft-De Rijp
Grajische Alpen	
Greet Hofmans	
Greet Hofmansaffaire	
Groene Boekje	Groenen Boekje
Groot Artesisch Bekken	Groeaut Artesisch bekken	Greauot Artesisch bekken	Greaut Artesisch bekken	Grood Artesisch bekken	Gro-ot Artesisch bekken	Grooth Artesisch bekken	Ggeroot Artesisch bekken	Chroot Artesisch bekken
Groot Australisch Scheidingsgebergte	
Groot Barrièrerif	
Grote Antillen	Groten Antillen
Grote Arabische Woestijn	Grothe Arabische Woestijn	Grotte Arabische Woestijn	Groten Arabische Woestijn	Grote Arabische Woestijn	Grotij Arabische Woestijn	Grode Arabische Woestijn	Grotai Arabische Woestijn	Greaute Arabische Woestijn
Grote Australische Bocht	Grothe Australische Bocht	Grotte Australische Bocht	Groten Australische Bocht	Grotij Australische Bocht	Grode Australische Bocht	Grotai Australische Bocht	Greaute Australische Bocht	Chrote Australische Bocht
Grote Bekken	Groten Bekken	Grote Bekke
Grote Belt	Groten Belt	Grote Beld
Grote Fatra	Groten Fatra
Grote Hongaarse Laagvlakte	Grothe Hongaarse Laagvlakte	Grotte Hongaarse Laagvlakte	Groten Hongaarse Laagvlakte	Grotij Hongaarse Laagvlakte	Grode Hongaarse Laagvlakte	Grotai Hongaarse Laagvlakte	Greaute Hongaarse Laagvlakte	Chrote Hongaarse Laagvlakte
Grote Kanaal	Groten Kanaal
Grote Kapela	Groten Kapela
Grote Meren	Groten Meren	Grote Mere	Grote Merijn
Grote Oceaan	Groten Oceaan
Grote Pier	Groten Pier
Grote Sint-Bernhardpas	Groten Sint-Bernhardpas
Grote Slenk	Groten Slenk	Grote Slek
Grote Soenda-eilanden	Groten Soenda-eilanden
Grote Van Dale	Grothe Van Dale	Grotte Van Dale	Groten Van Dale	Grotij Van Dale	Grode Van Dale	Grotai Van Dale	Greaute Van Dale	Chrote Van Dale
Grote Victoriawoestijn	Grote Victoriawoestijn	Groten Victoriawoestijn
Grote Visbaai	Groten Visbaai
Grote Vissersbank	Groten Vissersbank
Grote Zandwoestijn	Grote Zandwoestijn	Groten Zandwoestijn
Grote Zoutwoestijn	Grote Zoutwoestijn	Groten Zoutwoestijn
Guido Gezelle	Guido Gezellen
Haarlemmerliede en Spaarnwoude	Haarlemmerliede e Spaarnwoude	Ha-arlemmerliede en Spaarnwoude	Haarlemmerli-ede en Spaarnwoude	Haarlenmmerliede en Spaarnwoude	Haarlemmenrliede en Spaarnwoude	Haarlemmerliende en Spaarnwoude	Haarlemmerlieden en Spaarnwoude	Haarlemmërsliede en Spaarnwoude	Haarllemmerliede en Spaarnwoude	Haarlemmerlliede en Spaarnwoude	Haarlemmerliedde en Spaarnwoude	Haarlijmmerliede en Spaarnwoude	Haarlemmijrliede en Spaarnwoude	Haarlemmerliijde en Spaarnwoude	Haarlemmerliedij en Spaarnwoude
Hare Majesteit	Haren Majesteit
Hare Majesteit de Koningin	Hare Majestheit de Koningin	Hare Majesteith de Koningin	Hare Majeste-it de Koningin	Hare Majestteit de Koningin	Hare Majessteit de Koningin	Haren Majesteit de Koningin	Hare Majensteit de Koningin	Hare Majestenit de Koningin	Hare Majesteit den Koningin	Hare Maijesteit de Koningin	Harij Majesteit de Koningin	Hare Majijsteit de Koningin	Hare Majestijit de Koningin	Hare Majesteit dij Koningin
Harer Majesteits	
Harry Houdini	
Heilige Stoel	Heiligen Stoel
Hella Haasse	
Henck Arron	Heck Arron
Hendrikus Colijn	Hendrikus Colijn	Hendricus Colijn
Henri Matisse	
Henry Ford	Henry Fort
Heren XVII	Here XVII	Heren-XVII
Herman Gorter	
Herman Melville	
Herman van Woerden	Henrman Van woerden	Hairman Van woerden	Hijrman Van woerden	Hërsman Van woerden	Herman van Woerde	Henrman van Woerden	Hërsman van Woerden	Hijrman van Woerden	Hairman van Woerden
Het Laatste Nieuws	Hait Laatste nieuws	Hed Laatste nieuws	Hijt Laatste nieuws	Het Laatsten nieuws	Hent Laatste nieuws	Heth Laatste nieuws
Het Parool	
Hirsi Ali	
Ho Chi Minhstad	Heau Chi Minhstad
Hoek van Holland	Ho-ek van Holland	Hoenk van Holland	Hoijk van Holland	Hoequ van Holland	Hoecc van Holland	Houtk van Holland	Hoaik van Holland	Heauek van Holland	Hoec van Holland	Hoe k van Holland
Hof van Twente	Heauf van Twente
Hoge Atlas	Hogen Atlas
Hoge Tatra	Hogen Tatra
Hoge Venen	Hoge Venijn	Hoge Vennen	Hoge Veen	Hogen Venen
Hooge Zwaluwe	Hooge Zwaluwen
Hoogland van Auvergne	Ho-ogland van Auvergne	Hooglland van Auvergne	Hooglandd van Auvergne	Hoochland van Auvergne	Heaugland van Auvergne	Hooggeland van Auvergne	Heauogland van Auvergne	Hoeaugland van Auvergne
Hoogland van Bolivia	Ho-ogland van Bolivia	Hooglland van Bolivia	Hooglandd van Bolivia	Hoochland van Bolivia	Heaugland van Bolivia	Hooggeland van Bolivia	Heauogland van Bolivia	Hoeaugland van Bolivia
Hoogland van Brazilië	Ho-ogland van Brazilië	Hooglland van Brazilië	Hooglandd van Brazilië	Hoochland van Brazilië	Heaugland van Brazilië	Hooggeland van Brazilië	Heauogland van Brazilië	Hoeaugland van Brazilië
Hoogland van Dekan	Ho-ogland van Dekan	Hooglland van Dekan	Hooglandd van Dekan	Hoochland van Dekan	Heaugland van Dekan	Hooggeland van Dekan	Heauogland van Dekan	Hoeaugland van Dekan
Hoogland van Guyana	Ho-ogland van Guyana	Hooglland van Guyana	Hooglandd van Guyana	Hoochland van Guyana	Heaugland van Guyana	Hooggeland van Guyana	Heauogland van Guyana	Hoeaugland van Guyana
Hoogland van Iran	Ho-ogland van Iran	Hooglland van Iran	Hooglandd van Iran	Hoochland van Iran	Heaugland van Iran	Hooggeland van Iran	Heauogland van Iran	Hoeaugland van Iran
Hoogland van Mexico	Ho-ogland van Mexico	Hooglland van Mexico	Hooglandd van Mexico	Hoochland van Mexico	Heaugland van Mexico	Hooggeland van Mexico	Heauogland van Mexico	Hoeaugland van Mexico
Hoogland van Shaba	Ho-ogland van Shaba	Hooglland van Shaba	Hooglandd van Shaba	Hoochland van Shaba	Heaugland van Shaba	Hooggeland van Shaba	Heauogland van Shaba	Hoeaugland van Shaba
Hoorn van Afrika	Hoirn van Afrika	Ho-orn van Afrika	Heaurn van Afrika	Heauorn van Afrika	Hoeaurn van Afrika
Horst aan de Maas	Horsth aan de Maas	Horst a-an de Maas	Horsst aan de Maas	Horst aan de Maass	Horst aan den Maas	Horent aan de Maas	Horst aan dij Maas	Horsd aan de Maas	Horscht aan de Maas	Heaurst aan de Maas
Hugo Brandt Corstius	Hoego Brandt Corstius	Hucho Brandt Corstius	Hijgo Brandt Corstius	Huggeo Brandt Corstius	Hugeau Brandt Corstius
Hugo Claus	
Hugo de Groot	Hugo Den groot	Hugo den Groot	Hoego de Groot	Hugo dij Groot	Hucho de Groot	Hijgo de Groot	Huggeo de Groot	Hugeau de Groot
IJzeren Poort	IJzeren Poort	IJzerenpoort
ISO 8859-1	
Iberisch Randgebergte	Iberisch Randgebergten
Idi Amin	
Ierse Zee	Ierse Zeen
Indisch-Antarctisch Bekken	Indisch-Antarctisch Bekke
Indische Archipel	
Indische Oceaan	
Internationaal Strafhof	
Internet Explorer	
Ionische Eilanden	
Ionische Zee	Ionische Zeen
Isaac Newton	Isaak Newton
Italiaans Schiereiland	
Ivan Pavlov	
Ivan de Verschrikkelijke	Ivan Dij verschrikkelijke	Ivan De verschrikkelijke	Ivan Den verschrikkelijke
J.R.R. Tolkien	
Jack Kerouac	
Jacques-Yves Cousteau	
Jagernath Lachmon	
James Joyce	Jamais Joyce
James Watt	Jamais Watt
Jan Adriaenszoon Leeghwater	IJan Adriaenszoon Leeghwater
Jan Campert	
Jan Cremer	
Jan Harm	
Jan Peter Balkenende	Jan Petter Balkenende
Jan Pieterszoon Coen	IJan Pieterszoon Coen
Jan Steen	Jan Stenen	Jan Stee	Jan Steijn
Japanse Binnenzee	
Japanse Zee	Japanse Zeen
Jean Jacques Rousseau	Jenan Jacques Rousseau	Jijan Jacques Rousseau	Jaian Jacques Rousseau	IJean Jacques Rousseau	Ëan Jacques Rousseau
Jean-Luc Dehaene	Jean-Luk Dehaene
Jean-Paul Sartre	
Jeanne d'Arc	
Jeroen Bosch	
Jeroen Brouwers	
Jezus Christus	
Jip en Janneke	Jip e Janneke	Jip en Jannetje	IJp en Janneke	IJip en Janneke
Joeri Gagarin	
Johan Huizinga	
Johan van Oldenbarnevelt	Jeauhan van Oldenbarnevelt	IJohan van Oldenbarnevelt
Johann Sebastian Bach	Jeauhann Sebastian Bach	IJohann Sebastian Bach
Johannes Calvijn	Johannes Kalvijn	Johannes Calvijn
Johannes Gutenberg	
Johannes Paulus II	Johanness Paulus II	Johannens Paulus II	Johannijs Paulus II	Johannesch Paulus II	Johannais Paulus II	Jeauhannes Paulus II	IJohannes Paulus II
Johannes Vermeer	
Johannes de Doper	Johannesch De doper	Johannes Dij doper	Johannijs De doper	Johannes Den doper	Johannens De doper	Johanness De doper	Jeauhannes De doper	Johannais De doper	IJohannes De doper
John Cockerill	
John F. Kennedy	
John Lennon	
Joop den Uyl	Joop de Uyl	Jo-op den Uyl	Joop dijn Uyl	Joop den Uijl	Jeaup den Uyl	Joop deden Uyl	Jeauop den Uyl	Joeaup den Uyl	IJoop den Uyl
Joop van den Ende	Joop Van dijn ende	Joop Van den enden	Jo-op Van den ende	Joop Van den ede	Joop Van de ende	Joeaup Van den ende	Jeauop Van den ende	Joop Van deden ende	Jeaup Van den ende	IJoop Van den ende
Joost van den Vondel	Jo-ost Van den vondel	Joosth Van den vondel	Joost Van de vondel	Joeaust Van den vondel	Jeauost Van den vondel	Joost Van deden vondel	Jeaust Van den vondel	Jooscht Van den vondel	Joosd Van den vondel	Joost Van dijn vondel	IJoost Van den vondel	Joosst Van den vondel
Joseph Haydn	Josef Haydn
Joseph Heller	Josef Heller
Joseph Luns	Josef Luns	Joseph Loens
Jozef Stalin	
Judas Iskariot	
Judas Taddeüs	
Jules Verne	
Julische Alpen	
Julius Caesar	
Julius Civilis	
Kaap Glossa	
Kaap Hoorn	Kaaphoorn
Kaap Matapan	
Kaap Sideros	
Kaap Sint-Vincent	
Kaap Soenion	
Kaap Verdebekken	
Kaap de Goede Hoop	Kaap Dij goede hoop	Kaap Dde goede hoop	Kaap De goeden hoop	Kaap Den goede hoop	Ka-ap De goede hoop	Caap De goede hoop	Kaap Dede goede hoop	Kaap Dai goede hoop	Ccaap De goede hoop	Quaap De goede hoop
Kanaal van Bristol	Kana-al van Bristol	Kanaall van Bristol	Quanaal van Bristol	Ccanaal van Bristol	Canaal van Bristol
Kanaal van Malta	Kanaall Van malta	Kana-al Van malta	Canaal Van malta	Ccanaal Van malta	Quanaal Van malta	Kanaal van Maltha
Kanaal van Otranto	Kana-al van Otranto	Kanaall van Otranto	Quanaal van Otranto	Ccanaal van Otranto	Canaal van Otranto
Kanaal van Sicilië	Kana-al van Sicilië	Kanaall van Sicilië	Quanaal van Sicilië	Ccanaal van Sicilië	Canaal van Sicilië
Karel Appel	
Karel V	
Karel de Grote	Karenl de Grote	Karel den Grote	Karell de Grote	Karijl de Grote	Karel dij Grote	Karail de Grote	Quarel de Grote	Ccarel de Grote	Carel de Grote
Karel de Stoute	Karenl de Stoute	Karel den Stoute	Karel de Stouten	Karell de Stoute	Karijl de Stoute	Karel dij Stoute	Karail de Stoute
Karische Poort	
Karl Marx	Karl Marks
Karnische Alpen	
Kaspische Laagte	Kaspische Laagtij	Kaspische Laagten
Kaspische Zee	Kaspische Zeen
Kazachse Bocht	
Kazachse Rug	Kazachse Rijg
Kazakse Bocht	
Kazakse Rug	Kazakse Rijg
Keltische Zee	Keltische Zeen
Kieler Bocht	
Kleine Antillen	Kleinen Antillen
Kleine Atlas	Kleinen Atlas
Kleine Balkan	Kleinen Balkan
Kleine Belt	Kleinen Belt	Kleine Beld
Kleine Fatra	Kleinen Fatra
Kleine Kapela	Kleinen Kapela
Kleine Karpaten	Kleinen Karpaten
Kleine Sint-Bernhardpas	Kleinen Sint-Bernhardpas
Kleine Soenda-eilanden	Kleinen Soenda-eilanden
Knut Folkerts	Knoet Folkerts
Koerse Haf	Koersen Haf
Koerse Schoorwal	Koersen Schoorwal
Kollumerland en Nieuwkruisland	Kollumerland e Nieuwkruisland	Kollumenrland en Nieuwkruisland	Kollumërsland en Nieuwkruisland	Kolloemerland en Nieuwkruisland	Kolllumerland en Nieuwkruisland	Kollumerlland en Nieuwkruisland	Kollumerlandd en Nieuwkruisland	Kollumijrland en Nieuwkruisland	Kollijmerland en Nieuwkruisland	Kollumairland en Nieuwkruisland	Keaullumerland en Nieuwkruisland
Koningin Charlotte-eilanden	
Koningin Elizabetheilanden	
Koninklijk Huis	Koninklijk Heus	Koninklijk Huis	Koninklijk Hoeis
Kota Radja	Quota Radja
Krimpen aan den IJssel	Krimpe aan den IJssel	Krimpen aan de IJssel	Krimpen a-an den IJssel	Krimpenn aan den IJssel	Krimpijn aan den IJssel	Krimpen aan dijn IJssel	Krimpain aan den IJssel	Krimpen aan deden IJssel	Qurimpen aan den IJssel
Kuala Lumpur	
Kustgebergte van Andalusië	Kusthgebergte van Andalusië	Kustgebergthe van Andalusië	Kustgebergtte van Andalusië	Kusstgebergte van Andalusië	Kustgenbergte van Andalusië	Kustgebenrgte van Andalusië	Kustgebergten van Andalusië	Kustgebërsgte van Andalusië	Koestgebergte van Andalusië	Kustgijbergte van Andalusië	Kustgebijrgte van Andalusië	Kustgebergtij van Andalusië	Kustchebergte van Andalusië	Kustgeberchte van Andalusië
La Paz	La Pass
Laagland van Turan	La-agland van Turan	Laaglland van Turan	Laaglandd van Turan	Laachland van Turan	Laaggeland van Turan	Llaagland van Turan
Laconische Golf	
Lage Tatra	Lagen Tatra	Laag Tatra
Lage Zwaluwe	Lage Zwaluwen	Lagen Zwaluwe	Laag Zwaluwe
Land van Herve	Landd van Herve	Lland van Herve
Land van Waas	Landd Van waas	Lland Van waas
Landengte van Kra	Landegte van Kra	Landengthe van Kra	Landengtte van Kra	Landenngte van Kra	Landengten van Kra	Landdengte van Kra	Landijngte van Kra	Landengtij van Kra	Landenchte van Kra	Landengde van Kra	Landaingte van Kra	Landengtai van Kra	Landenggete van Kra	Landedengte van Kra
Landengte van Panama	Landenggete Van panama	Landengtai Van panama	Landaingte Van panama	Landengde Van panama	Landenchte Van panama	Landengtij Van panama	Landijngte Van panama	Landdengte Van panama	Llandengte Van panama	Landengten Van panama	Landenngte Van panama	Landengtte Van panama	Landengthe Van panama	Landegte Van panama
Laurens Janszoon Coster	Laures Janszoon Coster	La-urens Janszoon Coster	Laurenss Janszoon Coster	Laurenns Janszoon Coster	Laoerens Janszoon Coster	Laurijns Janszoon Coster	Laijrens Janszoon Coster	Laurensch Janszoon Coster	Laurains Janszoon Coster	Llaurens Janszoon Coster
Lee Harvey Oswald	Le-e Harvey Oswald	Lene Harvey Oswald	Leen Harvey Oswald	Lije Harvey Oswald	Leij Harvey Oswald	Lé Harvey Oswald	Lë Harvey Oswald	Laie Harvey Oswald	Leai Harvey Oswald	Llee Harvey Oswald
Leidsche Rijn	Leidsche Rein	Leidsche Rijn
Lejzer Zamenhof	
Leo Belgicus	
Leonardo da Vinci	Leontardo da Vinci	Lenonardo da Vinci	Leonarddo da Vinci	Lijonardo da Vinci	Laionardo da Vinci	Leeaunardo da Vinci	Leonardeau da Vinci	Lleonardo da Vinci
Lewis Carroll	
Libisch Plateau	
Libische Woestijn	Libische Woestijn
Ligurische Alpen	
Ligurische Apennijnen	Ligurische Apennijnen
Ligurische Zee	Ligurische Zeen
Linus Torvalds	
Liparische Eilanden	
Lister Diep	Lister Dip
Lodewijk Napoleon	Lodewijk Napoleon
Lodewijk XIV	Lodewijk XIV
Loe de Jong	Lout De jong	Loe Dij jong	Loij De jong	Loe Den jong	Loen De jong	Lo-e De jong	Leaue De jong	Loai De jong	Lloe De jong
Loon op Zand	Loeaun Op zand	Leauon Op zand	Leaun Op zand	Lo-on Op zand	Loon Op zant	Loont Op zand	Lloon Op zand	Loon op Zant
Louis Couperus	
Louis Pasteur	
Louis Paul Boon	
Luchtmobiele Brigade	Luchtmobiele Brigaden
Ludwig van Beethoven	Loedwig van Beethoven	Luddwig van Beethoven	Ludwich van Beethoven	Lijdwig van Beethoven	Ludwigge van Beethoven	Lludwig van Beethoven
Lübecker Bocht	
Maarten Luther	Maarte Luther	Maar ten Luther	Maarden Luther
Mahatma Gandhi	
Mao Zedong	
Marco Polo	Marko Polo
Marcus Cicero	Markus Cicero
Margaretha van Parma	Margarethha van Parma	Margarentha van Parma	Margarijtha van Parma	Marcharetha van Parma	Margaredha van Parma	Margaraitha van Parma	Marggearetha van Parma
Maria Magdalena	
Marilyn Monroe	
Mark Twain	Mark Twen	Marc Twain
Marten Toonder	Martijn Toonder	Marte Toonder	Marden Toonder
Martin Luther King Jr.	
Max Havelaar	Maks Havelaar
Mazurisch Merenplateau	
Meer van Genève	Me-er van Genève	Mener van Genève	Meenr van Genève	Meërs van Genève	Mijer van Genève	Meijr van Genève	Mér van Genève	Mër van Genève	Maier van Genève	Meair van Genève
Meer van Lugano	Me-er van Lugano	Mener van Lugano	Meenr van Lugano	Meërs van Lugano	Mijer van Lugano	Meijr van Lugano	Mér van Lugano	Mër van Lugano	Maier van Lugano	Meair van Lugano
Meer van Maracaibo	Me-er van Maracaibo	Mener van Maracaibo	Meenr van Maracaibo	Meërs van Maracaibo	Mijer van Maracaibo	Meijr van Maracaibo	Mér van Maracaibo	Mër van Maracaibo	Maier van Maracaibo	Meair van Maracaibo
Meer van Ohrid	Me-er van Ohrid	Mener van Ohrid	Meenr van Ohrid	Meërs van Ohrid	Mijer van Ohrid	Meijr van Ohrid	Mér van Ohrid	Mër van Ohrid	Maier van Ohrid	Meair van Ohrid
Meer van Shkodër	Me-er van Shkodër	Mener van Shkodër	Meenr van Shkodër	Meërs van Shkodër	Mijer van Shkodër	Meijr van Shkodër	Mér van Shkodër	Mër van Shkodër	Maier van Shkodër	Meair van Shkodër
Meer van Tiberias	Me-er van Tiberias	Mener van Tiberias	Meenr van Tiberias	Meërs van Tiberias	Mijer van Tiberias	Meijr van Tiberias	Mér van Tiberias	Mër van Tiberias	Maier van Tiberias	Meair van Tiberias
Mein Kampf	Mien Kampf	Mijn Kampf
Michael Jackson	
Michiel Adriaenszoon de Ruyter	Michiel Adriaeszoon de Ruyter	Michiel Adriaenszoont de Ruyter	Michiel Adria-enszoon de Ruyter	Michi-el Adriaenszoon de Ruyter	Michiel Adriaenszo-on de Ruyter	Michiel Adriaensszoon de Ruyter	Michienl Adriaenszoon de Ruyter	Michiel Adriaennszoon de Ruyter	Michiel Adriaenszoon den Ruyter	Michiell Adriaenszoon de Ruyter	Michiel Addriaenszoon de Ruyter	Mikhiel Adriaenszoon de Ruyter	Misshiel Adriaenszoon de Ruyter	Michiijl Adriaenszoon de Ruyter	Michiel Adriaijnszoon de Ruyter
Michiel de Ruyter	Michi-el de Ruyter	Michienl de Ruyter	Michiel den Ruyter	Michiell de Ruyter	Mikhiel de Ruyter	Misshiel de Ruyter	Michiijl de Ruyter	Michiel dij Ruyter	Michiel de Ruijter	Migiel de Ruyter	Michyl de Ruyter	Michy'l de Ruyter	Michiail de Ruyter	Michil de Ruyter
Midden-Atlantische Rug	Midden-Atlantische
Midden-Siberisch Bergland	
Mikhail Gorbatsjov	Michail Gorbatsjov
Mill en Sint Hubert	Mill e Sint Hubert	Mill enn Sint Hubert	Milll en Sint Hubert	Mill ijn Sint Hubert	Mill ain Sint Hubert
Moeder Theresa	
Mohammed Ali	
Molukse Zee	Molukse Zeen
Mona Lisa	
Mongoolse Altaj	
Mont Blanc	Mont Blank	Mond Blanc
Mont Ventoux	Mond Ventoux
Mook en Middelaar	Mooqu En middelaar	Moeauc En middelaar	Meauk En middelaar	Mo-ok En middelaar	Mook E middelaar	Mooké En middelaar	Mooc En middelaar	Moeauk En middelaar	Meauok En middelaar	Moocc En middelaar
Moravische Poort	
Moslim-Kroatische Federatie	Moslim-Kroatische Federatie	Moslim--Kroatische Federatie	Moslims-Kroatische Federatie	Moslima-Kroatische Federatie
Mount Everest	
Máxima Zorreguieta	
Nabije Oosten	Nabije Oosten
Napoleon Bonaparte	
Nationaal Volkscongres	
Nauw van Kales	Na-uw van Kales	Naoew van Kales	Nauw van Kalles	Naijw van Kales
Nederlandse Hartstichting	
Nederlandse Taalunie	Nederlandse Daalunie
Neil Armstrong	Nijl Armstrong	Niel Armstrong
Nelson Mandela	
Neusiedler Meer	Neusiedler Maier
New Delhi	
New Delhisch	
New Delhiër	
New York Times	Nenw York Times	Nijw York Times	Naiw York Times
Nicolaas Beets	Nikolaas Beets
Nienke van Hichtum	Nieke van Hichtum	Ni-enke van Hichtum	Niennke van Hichtum	Nienken van Hichtum	Nientje van Hichtum	Niijnke van Hichtum	Nienkij van Hichtum	Nynke van Hichtum	Ny'nke van Hichtum	Nienque van Hichtum	Niencce van Hichtum	Niainke van Hichtum	Nienkai van Hichtum	Nience van Hichtum	Ninke van Hichtum
Nieuw-Siberische Eilanden	
Nieuw-Zeelandse Alpen	
Nieuwe Pekela	Nieuwen Pekela
Nieuwerkerk aan den IJssel	Nieuwerkerk aan de IJssel	Nieuwerkerk a-an den IJssel	Nie-uwerkerk aan den IJssel	Ni-euwerkerk aan den IJssel	Nienuwerkerk aan den IJssel	Nieuwenrkerk aan den IJssel	Nieuwerkenrk aan den IJssel	Nieuwërskerk aan den IJssel	Nieuwerkërsk aan den IJssel	Nieoewerkerk aan den IJssel	Nieuwertjerk aan den IJssel	Niijuwerkerk aan den IJssel	Nieuwijrkerk aan den IJssel	Nieuwerkijrk aan den IJssel	Nieuwerkerk aan dijn IJssel
Noord-Amerikaans Bekken	Noord-Amerikaans Bekke
Noord-Chinees Bergland	
Noord-Duitse Laagvlakte	Noord-Duitse Laagvlakten
Noord-Equatoriale Rug	Noord-Equatoriale
Noord-Friese Waddeneilanden	Noord-Friesen Waddeneilanden
Noord-Russische Rug	Noord-Russische
Noord-Tiroler Alpen	
Noordelijk Territorium	Noordelijk Territorium
Noordelijke IJszee	Noordelijke IJszee	Noordelijken IJszee
Noordelijke Marianen	Noordelijken Marianen	Noordelijke Marianen
Noordoostelijke Doorvaart	Noordoostelijke Doorvaart
Noordwestelijke Doorvaart	Noordwestelijke Doorvaart
Noorse Bekken	Noorse Bekke
Noorse Zee	Noorse Zeen
Novum Instrumentum	
Nubische Woestijn	Nubische Woestijn
Oliver Cromwell	
Onderwijsbond CNV	
Oost-Afrikaans Hoogland	
Oost-Chinese Zee	Oost-Chinese Zeen
Oost-Friese Waddeneilanden	Oost-Friesen Waddeneilanden
Oost-Indisch doof	
Oost-Pacifische Rug	Oost-Pacifische Rijg
Oost-Siberische Zee	Oost-Siberische
Oostelijke Cordillera	Oostelijke Cordillera
Oostelijke Grote Erg	Oostelijkij Grote erg	Oostijlijke Grote erg	Oostelijke Grote erg	Oostelijtje Grote erg	Oostellijke Grote erg	Oostelijke Groten erg	Oostenlijke Grote erg	Oostelijken Grote erg	Oosstelijke Grote erg	Oosttelijke Grote erg	O-ostelijke Grote erg	Oosteli-jke Grote erg	Oosthelijke Grote erg
Oostelijke Sierra Madre	Oosthelijke Sierra Madre	Oosteli-jke Sierra Madre	Oosttelijke Sierra Madre	Oosstelijke Sierra Madre	Oostenlijke Sierra Madre	Oostelijken Sierra Madre	Oostellijke Sierra Madre	Oostelijtje Sierra Madre	Oostelijke Sierra Madre	Oostijlijke Sierra Madre	Oostelijkij Sierra Madre	Oosdelijke Sierra Madre	Ooschtelijke Sierra Madre	Oosteleike Sierra Madre
Oostenrijkse Alpen	Oostenrijkse Alpen
Oostenrijkse Hoogvlakte	Oostenrijkse Hoogvlakte	Oostenrijkse Hoogvlakten
Oranje Vrijstaat	Oranje Vrijstaat	Oranje-Vrijstaat
Osama Bin Laden	
Oscar Wilde	Oskar Wilde	Oscar Wilden
Ossip Zadkine	
Oude IJssel	Ouden IJssel
Oude IJsselstreek	Ouden IJsselstreek
Oude Pekela	Ouden Pekela
Pablo Picasso	
Pacifisch-Antarctisch Bekken	Pacifisch-Antarctisch Bekke
Paul Gauguin	
Paul Verhoeven	Paul Verhoeve
Paul van Ostaijen	Pa-ul van Ostaijen	Paoel van Ostaijen	Paull van Ostaijen	Paul van Ostaijen	Paijl van Ostaijen
Pelagische Eilanden	
Penninisch Gebergte	Penninisch Gebergten
Perzische Golf	
Piet Mondriaan	Pit Mondriaan
Pieter Jelles Troelstra	Piether Jelles Troelstra	Pi-eter Jelles Troelstra	Pietter Jelles Troelstra	Pienter Jelles Troelstra	Pietenr Jelles Troelstra	Pietërs Jelles Troelstra	Piijter Jelles Troelstra	Pietijr Jelles Troelstra	Pieder Jelles Troelstra	Pyter Jelles Troelstra	Py'ter Jelles Troelstra	Piaiter Jelles Troelstra	Pietair Jelles Troelstra	Piter Jelles Troelstra
Pieter Pauwel Rubens	Piether Pauwel Rubens	Pi-eter Pauwel Rubens	Pietter Pauwel Rubens	Pienter Pauwel Rubens	Pietenr Pauwel Rubens	Pietërs Pauwel Rubens	Piijter Pauwel Rubens	Pietijr Pauwel Rubens	Pieder Pauwel Rubens	Pyter Pauwel Rubens	Py'ter Pauwel Rubens	Piaiter Pauwel Rubens	Pietair Pauwel Rubens	Piter Pauwel Rubens
Pim Fortuyn	Pim Fortuijn
Pink Floyd	
Plakkaat van Verlatinghe	Plakkaath van Verlatinghe	Plakka-at van Verlatinghe	Pllakkaat van Verlatinghe	Plakkaad van Verlatinghe	Plaqukaat van Verlatinghe	Plakquaat van Verlatinghe	Placcaat van Verlatinghe	Placckaat van Verlatinghe	Plakccaat van Verlatinghe	Plackaat van Verlatinghe	Plakcaat van Verlatinghe
Plateau van Lotharingen	Platheau van Lotharingen	Platea-u van Lotharingen	Platteau van Lotharingen	Platenau van Lotharingen	Plateaoe van Lotharingen	Pllateau van Lotharingen	Platijau van Lotharingen	Pladeau van Lotharingen	Plateaij van Lotharingen	Plataiau van Lotharingen
Pommers Merenplateau	
Pommerse Bocht	
Pontisch Gebergte	Pontisch Gebergten
Pontius Pilatus	
Pools Laagland	
Poort van Trajanus	Poorth van Trajanus	Poirt van Trajanus	Po-ort van Trajanus	Poord van Trajanus	Peaurt van Trajanus	Peauort van Trajanus	Poeaurt van Trajanus
Port Louis	
Port Moresby	
Port Said	
Port Sudan	Port Soedan
Port Vila	Port Villa
Port of Spain	Porth of Spain	Pord of Spain	Peaurt of Spain
Prins Alexander	Prins Aleksander
Prins Edwardeiland	
Ray Bradbury	
Rede van Brest	Rende van Brest	Reden van Brest	Redde van Brest	Rijde van Brest	Redij van Brest	Rte van Brest	Raide van Brest	Redai van Brest	Redede van Brest
Rembrandt van Rijn	Rembrandth van Rijn	Renmbrandt van Rijn	Rembranddt van Rijn	Rembrandt van Rijn	Rijmbrandt van Rijn	Rembrandd van Rijn	Rembrandt van Rein	Raimbrandt van Rijn
René Descartes	Renee Descartes
Republiek Sacha	Republiek Saga
Richard Leeuwenhart	
Richard M. Stallman	Richardd M. Stallman	Rikhard M. Stallman	Risshard M. Stallman	Rigard M. Stallman
Rio Grande	
Rio de Janeiro	Rio den Janeiro	Rio dij Janeiro	Rieau de Janeiro
Road Town	Road Down
Robert Jan	Robert-Jan
Rode Bekken	Roden Bekken	Rode Bekke
Rode Kruisauto	Roden Kruisauto
Rode Rivier	Roden Rivier
Rode Torenpas	Rode Torenpass	Roden Torenpas
Rode Zee	Rode Zeen	Roden Zee
Roggel en Neer	Roggijl En neer	Roggell En neer	Roggenl En neer	Roggel E neer	Reauggel En neer	Rogggeel En neer	Roggegel En neer	Roggail En neer	Rochel En neer	Rogchel En neer	Rochgel En neer
Romeo en Julia	Romeo e Julia	Romeno en Julia	Romijo en Julia	Romaio en Julia	Reaumeo en Julia	Romeeau en Julia
Rudolf Steiner	
Russisch Laagland	
Ruud Lubbers	
Saint George's	
Saint John's	
Saint Kitts en Nevis	Saint Kitts e Nevis	Sainth Kitts en Nevis	Saint Kithts en Nevis	Saint Kitths en Nevis	Sent Kitts en Nevis	Sa-int Kitts en Nevis	Saint Kittss en Nevis	Saind Kitts en Nevis	Saint Kidts en Nevis	Saint Kitds en Nevis	Saint Kittsch en Nevis
Saint Lawrencebaai	
Saint Lucia	
Saint Luciaan	
Saint Luciaans	
Saint Vincent en de Grenadines	Saint Vincet en de Grenadines	Saint Vincent e de Grenadines	Sainth Vincent en de Grenadines	Saint Vincenth en de Grenadines	Sent Vincent en de Grenadines	Sa-int Vincent en de Grenadines	Saint Vincennt en de Grenadines	Saint Vincent enn de Grenadines	Saint Vincent en den Grenadines	Saint Vinkent en de Grenadines	Saint Vinssent en de Grenadines	Saint Vincijnt en de Grenadines	Saint Vincent ijn de Grenadines	Saint Vincent en dij Grenadines	Saind Vincent en de Grenadines
Saint-Pierre en Miquelon	Saint-Pierre e Miquelon	Sainth-Pierre en Miquelon	Sent-Pierre en Miquelon	Sa-int-Pierre en Miquelon	Saint-Pi-erre en Miquelon	Saint-Pienrre en Miquelon	Saint-Pierren en Miquelon	Saint-Piërsre en Miquelon	Saint-Piijrre en Miquelon	Saint-Pierrij en Miquelon	Saind-Pierre en Miquelon	Saint-Pyrre en Miquelon	Saint-Py'rre en Miquelon	Saint-Piairre en Miquelon	Saint-Pierrai en Miquelon
Salman Rushdie	
Salvador Allende	
San José	
San Juan	
San Salvador	Salvadoraan
San Sebastian	
Sankt Vith	
Santiago de Compostela	Santhiago de Compostela	Santiago den Compostela	Santiago de Compostella	Santiago dij Compostela	Santiacho de Compostela	Sandiago de Compostela	Santiaggeo de Compostela	Santiageau de Compostela	Ssantiago de Compostela
Santiago de Compostella	Santhiago de Compostella	Santiago den Compostella	Santiago dij Compostella	Santiacho de Compostella	Sandiago de Compostella	Santiaggeo de Compostella	Santiageau de Compostella	Ssantiago de Compostella	Schantiago de Compostella
Santo Domingo	
Sao Tomé	
Sao Tomé en Principe	Sao Teaumé en principe	Saeau Tomé en principe	Sao Domé en principe	Sao Tomee en principe	Sao Thomé en principe	Sao Tomé e principe	Schao Tomé en principe	Ssao Tomé en principe
Savoyse Alpen	
Saïdjah en Adinda	Saïdjah e Adinda	Saïddjah en Adinda	Saïdijah en Adinda	Sa-idjah en Adinda	Saiidjah en Adinda	Ssaïdjah en Adinda	Schaïdjah en Adinda
Scandinavisch Hoogland	
Schotse Laagvlakte	Schotse Laagvlakten	Schotsen Laagvlakte
Servische Republiek	
Sierra Leone	
Sierra Leoner	
Sierra Leoons	
Sierra Leoonse	
Sigmund Freud	
Simon Petrus	
Simon Stevin	
Simon Vestdijk	Simon Vestdijk
Sint Anthonis	
Slot Loevestein	
Slovaaks Ertsgebergte	Slovaaks Ertsgebergten
Slowaaks Ertsgebergte	Slowaaks Ertsgebergten
Snelle Cris	Snelle Kris	Snellen Cris
Snelle Körös	Snellen Körös
Somalisch Hoogland	
Somalisch Schiereiland	
Son en Breugel	Son e Breugel	Sont en Breugel	Seaun en Breugel	Sson en Breugel	Schon en Breugel
Spaanse Hoogvlakte	Spaanse Hoogvlakten	Spaansen Hoogvlakte
Stede Broec	Stede Broek	Steden Broec
Stille Oceaan	Stillen Oceaan
Stille Zuidzee	Stillen Zuidzee
Straat Bass	
Straat Cook	Straat Kook
Straat Davis	
Straat De Long	Sdraat De long	Straat Dij long	Straat Den long	Stra-at De long	Straath De long	Sthraat De long	Schtraat De long	Straad De long	Sstraat De long
Straat Denemarken	
Straat Drake	Straat Draken
Straat Florida	
Straat Formosa	
Straat Hinlopen	
Straat Hudson	
Straat Joegor	
Straat Karimata	
Straat Koerilen	
Straat Koningin Charlotte	Sthraat Koningin Charlotte	Straath Koningin Charlotte	Stra-at Koningin Charlotte	Sdraat Koningin Charlotte	Straad Koningin Charlotte	Sstraat Koningin Charlotte	Schtraat Koningin Charlotte
Straat Korea	
Straat La Pérouse	Sthraat La Pérouse	Straath La Pérouse	Stra-at La Pérouse	Sdraat La Pérouse	Straad La Pérouse	Sstraat La Pérouse	Schtraat La Pérouse
Straat Madoera	
Straat Magallanes	
Straat Magellaan	
Straat Makassar	
Straat Malakka	
Straat Mozambique	
Straat Nares	
Straat Palk	Straatspalk
Straat Singapore	
Straat Soemba	
Straat Soenda	
Straat Torres	
Straat Tsugaru	
Straat Yucatan	
Straat van Bonifacio	Sthraat van Bonifacio	Straath van Bonifacio	Stra-at van Bonifacio	Sdraat van Bonifacio	Straad van Bonifacio	Sstraat van Bonifacio	Schtraat van Bonifacio
Straat van Corsica	Sthraat van Corsica	Straath van Corsica	Stra-at van Corsica	Sdraat van Corsica	Straad van Corsica	Sstraat van Corsica	Schtraat van Corsica
Straat van Gibraltar	Sthraat van Gibraltar	Straath van Gibraltar	Stra-at van Gibraltar	Sdraat van Gibraltar	Straad van Gibraltar	Sstraat van Gibraltar	Schtraat van Gibraltar
Straat van Hormuz	Sthraat van Hormuz	Straath van Hormuz	Stra-at van Hormuz	Sdraat van Hormuz	Straad van Hormuz	Sstraat van Hormuz	Schtraat van Hormuz
Straat van Messina	Sthraat van Messina	Straath van Messina	Stra-at van Messina	Sdraat van Messina	Straad van Messina	Sstraat van Messina	Schtraat van Messina
Straat van Taiwan	Sthraat van Taiwan	Straath van Taiwan	Stra-at van Taiwan	Sdraat van Taiwan	Straad van Taiwan	Sstraat van Taiwan	Schtraat van Taiwan
Syrische Woestijn	Syrische Woestijn
Te Deum	Tai Deum	Te  Deum	Ten Deum	Tij Deum	De Deum
Ten Boer	Tijn Boer	Te Boer	Den Boer	Te N boer
Ter Aar	Der Aar	Ter  aar	Te R aar	Termaar	Terhaar
The Beatles	Then Beatles	Thij Beatles	Thai Beatles
The Rolling Stones	Then Rolling Stones	Thij Rolling Stones	Thai Rolling Stones	Thhe Rolling Stones	Dhe Rolling Stones
The Valley	Then Valley	Thij Valley	Thai Valley
Theo van Gogh	Theno van Gogh	Thijo van Gogh	Thaio van Gogh	Theeau van Gogh	Thheo van Gogh	Dheo van Gogh
Theodore Roosevelt	
Thomas Alva Edison	Thomass Alva Edison	Thomasch Alva Edison	Theaumas Alva Edison	Thhomas Alva Edison	Dhomas Alva Edison
Thomas Jefferson	
Tibetaans Hoogland	
Tony Blair	
Toscaanse Archipel	
Transsylvanische Alpen	
Trasimeense Meer	Trasimeense Maier
Trinidad en Tobago	Trinidad e Tobago	Triniddad en Tobago	Trinidadd en Tobago	Thrinidad en Tobago	Drinidad en Tobago
Tsjang K'ai-Sjek	
Turks- en Caicoseilanden	Turks- e Caicoseilanden	Turkss- en Caicoseilanden	Toerks- en Caicoseilanden	Tijrks- en Caicoseilanden	Turksch- en Caicoseilanden	Turx- en Caicoseilanden	Turct- en Caicoseilanden	Turcz- en Caicoseilanden	Turqus- en Caicoseilanden	Turcc- en Caicoseilanden	Turccs- en Caicoseilanden	Turcs- en Caicoseilanden	Thurks- en Caicoseilanden
Tweede Kamerverkiezingen	Tweeden Kamerverkiezingen	 tweede Kamerverkiezingen	Tweede Kamerverkiezingen
Tyrreense Zee	Tyrreense Zeen
Ubach over Worms	Ubakh over Worms	Ubassh over Worms	Ubag over Worms	Oebach over Worms	IJbach over Worms
Utrechtse Heuvelrug	
Vader des Vaderlands	Vadeder Des vaderlands	Vadair Des vaderlands	Vadijr Des vaderlands	Vadder Des vaderlands	Vadërs Des vaderlands	Vadenr Des vaderlands
Valkenburg aan de Geul	Valkenburgge Aan de geul	Valkainburg Aan de geul	Valccenburg Aan de geul	Valquenburg Aan de geul	Valkenbijrg Aan de geul	Valkenburch Aan de geul	Valkenburg Aan dij geul	Valkijnburg Aan de geul	Valtjenburg Aan de geul	Vallkenburg Aan de geul	Valkenboerg Aan de geul	Valkenburg Aan den geul	Valkennburg Aan de geul	Valkenburg A-an de geul	Valkeburg Aan de geul
Vallei van Fergana	Valle-i van Fergana	Valleni van Fergana	Valllei van Fergana	Valliji van Fergana	Vallij van Fergana	Vallaii van Fergana	Vallie van Fergana
Van Acker	Van Akker	^van  Acker
Van Agt	Van Acht	^van  Agt
Van Dale	Van Dalai	Van Dalen	^van  Dale
Van Damme	Van Dammen	^van  Damme	Vandamme
Van Dyck	Van Dijck	^van  Dyck
Van Hecke	^van  Hecke
Van Heuven Goedhart	^van  Heuven Goedhart
Van Hoof	Van Hoofd	^van  hoof
Van de Velde	Van De vijlde	Van Dij velde	Van De velden	Van Den velde	^van  de velde
Van den Bossche	Van de Bossche	Van dijn Bossche	Van deden Bossche	^van  den Bossche
Van den Broeck	Van de Broeck	Van dijn Broeck	Van deden Broeck	^van  den Broeck
Venetiaanse Alpen	
Vereenigde Oost-Indische Compagnie	Vereeigde Oost-Indische Compagnie	Vere-enigde Oost-Indische Compagnie	Venreenigde Oost-Indische Compagnie	Verenenigde Oost-Indische Compagnie	Vereennigde Oost-Indische Compagnie	Vereenigden Oost-Indische Compagnie	Vërseenigde Oost-Indische Compagnie	Vereenigdde Oost-Indische Compagnie	Vijreenigde Oost-Indische Compagnie	Verijenigde Oost-Indische Compagnie	Vereijnigde Oost-Indische Compagnie	Vereenigdij Oost-Indische Compagnie	Vereenichde Oost-Indische Compagnie	Verénigde Oost-Indische Compagnie	Verënigde Oost-Indische Compagnie
Verenigd Koninkrijk	Verenigd Koninkrijk
Verre Oosten	Verrekoosten
Vincent van Gogh	Vincet van Gogh	Vincenth van Gogh	Vincennt van Gogh	Vinkent van Gogh	Vinssent van Gogh	Vincijnt van Gogh	Vincend van Gogh	Vincaint van Gogh
Vladimir Lenin	Vladimir Lein
Vladimir Poetin	
Vlakte van Jizreël	Vlakthe van Jizreël	Vlaktte van Jizreël	Vlakten van Jizreël	Vllakte van Jizreël	Vlaktij van Jizreël	Vlakde van Jizreël	Vlaxe van Jizreël	Vlaqute van Jizreël	Vlaccte van Jizreël	Vlaktai van Jizreël	Vlacte van Jizreël
Vleuten-De Meern	Vleuten-Den Meern	Vleuten-Dij Meern
Volksrepubliek China	
Vrouwe Justitia	Vrouwen Justitia
W.F. Hermans	
W.G. van de Hulst	W.gge. Van de hulst	W.ch. Van de hulst	W.g. Van dij hulst	W.g. Van den hulst	W.G. van den Hulst	W.G. van dij Hulst
Wallis en Futuna	Wallis e Futuna	Walliss en Futuna	Walllis en Futuna	Wallisch en Futuna	Waljs en Futuna	Wallliss en Futuna
West Maas en Waal	Wesst Maas en waal	West Ma-as en waal	Westh Maas en waal	West Maas e waal	Waist Maas en waal	West Maasch en waal	Wescht Maas en waal	Wesd Maas en waal	Wijst Maas en waal	Wenst Maas en waal	West Maass en waal
West-Europees Bekken	West-Europees Bekke
West-Siberisch Laagland	
Westelijk Nieuw-Guinea	Westelijk Nieuw-Guinea
Westelijke Balkan	Westelijke Balkan	Westelijken Balkan
Westelijke Cordillera	Westelijke Cordillera	Westelijken Cordillera
Westelijke Dvina	Westelijke Dvina	Westelijken Dvina
Westelijke Grote Erg	Westijlijke Grote erg	Wijstelijke Grote erg	Westelijke Grote erg	Westelijtje Grote erg	Westellijke Grote erg	Westelijke Groten erg	Westenlijke Grote erg	Westelijken Grote erg	Wenstelijke Grote erg	Wesstelijke Grote erg	Westtelijke Grote erg	Westeli-jke Grote erg	Westhelijke Grote erg
Westelijke Jordaanoever	Westelijke Jordaanoever	Westelijken Jordaanoever
Westelijke Morava	Westelijke Morava	Westelijken Morava
Westelijke Sierra Madre	Westhelijke Sierra Madre	Westeli-jke Sierra Madre	Westtelijke Sierra Madre	Wesstelijke Sierra Madre	Wenstelijke Sierra Madre	Westenlijke Sierra Madre	Westelijken Sierra Madre	Westellijke Sierra Madre	Westelijtje Sierra Madre	Westelijke Sierra Madre	Wijstelijke Sierra Madre	Westijlijke Sierra Madre	Westelijkij Sierra Madre	Wesdelijke Sierra Madre
Wijk bij Duurstede	Wijk Bij duursteden	Wi-jk bij Duurstede	Wijk bij Duurstede	Weik bij Duurstede	Wijqu bij Duurstede	Wijcc bij Duurstede	Wijc bij Duurstede
Willem Aantjes	
Willem Barentsz	
Willem Drees	Willem Drés
Willem Elsschot	
Willem Frederik Hermans	Willenm Frederik Hermans	Willlem Frederik Hermans	Willijm Frederik Hermans	Willaim Frederik Hermans	Willem Frederic Hermans
Willem Janszoon Blaeu	Willenm Janszoon Blaeu	Willlem Janszoon Blaeu	Willijm Janszoon Blaeu	Willaim Janszoon Blaeu
Willem V	
Willem de Veroveraar	Willaim De veroveraar	Willem Dij veroveraar	Willijm De veroveraar	Willlem De veroveraar	Willem Den veroveraar	Willenm De veroveraar
Willem de Zwijger	Willenm de Zwijger	Willem den Zwijger	Willlem de Zwijger	Willem de Zwijger	Willijm de Zwijger	Willem dij Zwijger	Willaim de Zwijger
Willem van Oranje	Willaim Van oranje	Willijm Van oranje	Willlem Van oranje	Willenm Van oranje	Willenm van Oranje	Willlem van Oranje	Willijm van Oranje	Willaim van Oranje
William Shakespeare	
Wim Kan	
Wim Kok	
Windward Passage	Windward Passsage
Winston Churchill	
Witte Boekje	Witten Boekje
Witte Cris	Witte Kris	Witten Cris
Witte Drin	Witten Drin
Witte Karpaten	Witten Karpaten
Witte Nijl	Witten Nijl	Witte Nijl	Witte Neil
Witte Volta	Witten Volta
Witte Zee	Witten Zee	Witte Zeen
Wolfgang Amadeus Mozart	Wollfgang Amadeus Mozart	Wolfchang Amadeus Mozart	Wolfganch Amadeus Mozart	Wolfggeang Amadeus Mozart	Wolfgangge Amadeus Mozart	Weaulfgang Amadeus Mozart
Wolynisch-Podolisch Plateau	
Yasser Arafat	
Zee van Azov	Ze-e van Azov	Zene van Azov	Zeen van Azov	Zije van Azov	Zeij van Azov	Zé van Azov	Zë van Azov	Zaie van Azov	Zeai van Azov	Ssee van Azov
Zee van Halmahera	Ze-e van Halmahera	Zene van Halmahera	Zeen van Halmahera	Zije van Halmahera	Zeij van Halmahera	Zé van Halmahera	Zë van Halmahera	Zaie van Halmahera	Zeai van Halmahera	Ssee van Halmahera
Zee van Marmara	Ze-e van Marmara	Zene van Marmara	Zeen van Marmara	Zije van Marmara	Zeij van Marmara	Zé van Marmara	Zë van Marmara	Zaie van Marmara	Zeai van Marmara	Ssee van Marmara
Zee van Ochotsk	Ze-e van Ochotsk	Zene van Ochotsk	Zeen van Ochotsk	Zije van Ochotsk	Zeij van Ochotsk	Zé van Ochotsk	Zë van Ochotsk	Zaie van Ochotsk	Zeai van Ochotsk	Ssee van Ochotsk
Zuid-Australisch Bekken	Zuid-Australisch Bekke
Zuid-Chinees Bergland	
Zuid-Chinese Zee	Zuid-Chinees
Zuid-Equatoriale Rug	Zuid-Equatoriale
Zuid-Pacifisch Bekken	Zuid-Pacifisch Bekke
Zuid-Pacifische Drempel	
Zuid-Schots Bergland	
Zuidelijke IJszee	Zuidelijke IJszee	Zuidelijken IJszee
Zuidelijke Karpaten	Zuidelijke Karpaten	Zuidelijken Karpaten
Zuidelijke Oceaan	Zuidelijke Oceaan	Zuidelijken Oceaan
Zuidelijke Sierra Madre	Zuideli-jke Sierra Madre	Zu-idelijke Sierra Madre	Zuidenlijke Sierra Madre	Zuidelijken Sierra Madre	Zoeidelijke Sierra Madre	Zuidellijke Sierra Madre	Zuidelijtje Sierra Madre	Zuiddelijke Sierra Madre	Zuidelijke Sierra Madre	Zuidijlijke Sierra Madre	Zuidelijkij Sierra Madre	Zijidelijke Sierra Madre	Zuideleike Sierra Madre	Zeudelijke Sierra Madre	Zuidelijque Sierra Madre
Zwarte Cris	Zwarte Kris	Zwartte Cris	Zwarten Cris
Zwarte Drin	Zwartte Drin	Zwarten Drin
Zwarte Volta	Zwarten Volta	Zwartte Volta
Zwarte Woud	Zwarten Woud	Zwartte Woud	Zwarte Wout
Zwarte Zee	Zwarten Zee	Zwarte Zeen	Zwartte Zee
Zweeds Terrasland	Zwets Terrasland
Zwitserse Hoogvlakte	Zwitserse Hoogvlakten
de Caraïben	den Caraïben	dij Caraïben
de Falklandeilanden	den Falklandeilanden	dij Falklandeilanden	Falklandeilanden	Falklandeilander
de Gaulle	den Gaulle	dij Gaulle
de Here	de Heren	den Here	dij Here
de Kaap	dij Kaap	den Kaap
de Kaukasus	den Kaukasus	dij Kaukasus
des onheils	deskonheils
ditjes en datjes	ditjes e datjes	dithjes en datjes	ditjess en datjes	ditjens en datjes	dditjes en datjes	ditijes en datjes	ditjijs en datjes	didjes en datjes	ditjesch en datjes	ditës en datjes	ditjais en datjes
gebroeders Grimm	
hertog van Alva	herthog van Alva	henrtog van Alva	hërstog van Alva	hijrtog van Alva	hertoch van Alva	herdog van Alva	hairtog van Alva	hertogge van Alva	herteaug van Alva
het Bildt	
het Breezand	
huis van Oranje	heus Van oranje	huisch Van oranje	hijis Van oranje	hoeis Van oranje	huiss Van oranje	hu-is Van oranje	hu-is van Oranje	huiss van Oranje	hoeis van Oranje	hijis van Oranje	huisch van Oranje	heus van Oranje
huis van Oranje-Nassau	hu-is van Oranje-Nassau	huiss van Oranje-Nassau	hoeis van Oranje-Nassau	hijis van Oranje-Nassau	huisch van Oranje-Nassau	heus van Oranje-Nassau
huis van Saksen-Coburg	hu-is van Saksen-Coburg	huiss van Saksen-Coburg	hoeis van Saksen-Coburg	hijis van Saksen-Coburg	huisch van Saksen-Coburg	heus van Saksen-Coburg
in voege	in voegen
koning Arthur	
koning Willem I	
koning Willem II	konting Willem II	konings Willem II	koninch Willem II	quoning Willem II	cconing Willem II	koningge Willem II	koniging Willem II	keauning Willem II	coning Willem II
koningin Beatrix	
koningin Juliana	
koningin Wilhelmina	
om 's hemelswil	eaum 's hemelswil
pater Damiaan	
pater Eustachius	
praten als Brugman	prate als Brugman	prathen als Brugman	pratten als Brugman	pratenn als Brugman	pratijn als Brugman	praden als Brugman	pratain als Brugman	praten als Bruggeman	prathan als Brugman
prins Bernhard	prins Bernhart
prins Claus	
real time	real timen	realtime
tale Kanaäns	talen Kanaäns
zo waarlijk helpe mij God Almachtig	zo wa-arlijk helpe mij God Almachtig	zo waarli-jk helpe mij God Almachtig	zo waarlijk helpe mi-j God Almachtig	zo waarlijk henlpe mij God Almachtig	zo waarlijk helpen mij God Almachtig	zo waarllijk helpe mij God Almachtig	zo waarlijk hellpe mij God Almachtig	zo waarlijk helpe mij God Almachtig	zo waarlijk hijlpe mij God Almachtig	zo waarlijk helpij mij God Almachtig	sso waarlijk helpe mij God Almachtig	zo waarleik helpe mij God Almachtig	zo waarlijk helpe mei God Almachtig	zo waarlijqu helpe mij God Almachtig
